EEGEWEEEE
EEPRRRRRE
DRREREERD
EERRPRRRE
EEWEEEEEE