EWEEEEDEEE
EPRRRRRRRR
EREREEEDER
ERERDEEEER
DRRRRRRRRR
EREREGEDER
ERERRRRRRR
EREREEDEER
ERRRRRRRRR
DREEEREPER
ERRDEDEWED